16 1 1 1 14 15 1 15 16 1 1 1 1 1 1 1 17 18 20 17 22 17 20 17 22 17 17 17 20 17 22 22 16 1 1 1 14 15 1 15 16 1 1 1 1 1 1 1 17 18 20 17 22 17 20 17 22 17 17 17 20 17 22 22
1 1 1 15 14 15 0 0 0 0 14 16 3 1 1 1 22 17 17 17 17 17 17 17 20 17 22 20 17 22 17 22 1 1 1 15 14 15 0 0 0 0 14 16 3 1 1 1 22 17 17 17 17 17 17 17 20 17 22 20 17 22 17 22
1 3 3 14 14 15 0 0 0 0 15 0 0 16 3 1 18 17 17 17 17 17 17 17 20 17 22 17 17 17 17 22 1 3 3 14 14 15 0 0 0 0 15 0 0 16 3 1 18 17 17 17 17 17 17 17 20 17 22 17 17 17 17 22
1 15 15 16 0 0 4 5 5 5 6 0 0 0 0 3 1 19 17 18 18 18 17 20 17 22 20 17 19 19 19 17 21 1 15 15 16 0 4 5 5 5 6 0 0 0 0 0 3 1 19 17 18 18 18 17 20 17 22 20 17 19 19 19 17 21
0 15 15 0 0 0 7 13 -1 -1 9 0 0 0 0 1 17 17 18 18 18 17 17 22 22 22 22 19 19 19 17 21 0 15 15 0 0 0 7 13 -1 -1 9 0 0 0 0 1 17 17 18 18 18 17 17 22 22 22 22 19 19 19 17 21
0 15 15 0 0 0 7 -1 -1 -1 9 0 0 0 0 0 20 17 18 18 18 17 17 22 22 22 22 19 19 19 17 21 0 15 15 0 0 0 7 -1 -1 -1 9 0 0 0 0 0 20 17 18 18 18 17 17 22 22 22 22 19 19 19 17 21
3 15 15 0 0 0 7 -1 -1 -1 9 0 0 0 0 0 21 17 17 17 17 17 17 22 22 22 22 17 17 17 17 21 3 15 15 0 0 0 7 -1 -1 -1 9 0 0 0 0 0 21 17 17 17 17 17 17 22 22 22 22 17 17 17 17 21
3 0 0 0 0 0 10 11 11 11 12 0 0 0 2 1 17 17 17 17 17 17 17 22 22 22 22 17 17 17 17 21 3 0 0 0 0 0 10 11 11 11 12 0 0 0 2 1 17 17 17 17 17 17 17 22 22 22 22 17 17 17 17 21
1 2 16 16 16 16 16 0 0 0 0 0 0 0 2 1 17 17 17 17 17 17 17 22 22 22 17 17 17 17 17 21 1 2 16 16 16 16 16 0 0 0 0 0 0 0 2 1 17 17 17 17 17 17 17 22 22 22 17 17 17 17 17 21
1 2 3 16 16 16 16 16 0 0 0 0 3 2 2 1 22 22 22 17 17 17 17 22 22 22 17 17 22 22 22 21 1 2 3 16 16 16 16 16 0 0 0 0 3 2 2 1 22 22 22 17 17 17 17 22 22 22 17 17 22 22 22 21
1 1 2 14 15 15 15 16 0 0 0 0 2 1 1 1 22 22 22 17 17 17 17 17 17 17 17 17 22 22 22 22 1 1 2 14 15 15 15 16 0 0 0 0 2 1 1 1 22 22 22 17 17 17 17 17 17 17 17 17 22 22 22 22
14 14 14 14 14 1 1 0 0 1 1 1 1 1 1 1 22 22 22 17 17 17 17 17 17 17 17 17 22 22 22 22 14 14 14 14 14 1 1 0 0 1 1 1 1 1 1 1 22 22 22 17 17 17 17 17 17 17 17 17 22 22 22 22
16 1 1 1 14 15 1 15 16 1 1 1 1 1 1 1 17 18 20 17 22 17 20 17 22 17 17 17 20 17 22 22 16 1 1 1 14 15 1 15 16 1 1 1 1 1 1 1 17 18 20 17 22 17 20 17 22 17 17 17 20 17 22 22
1 1 1 15 14 15 0 0 0 0 14 16 3 1 1 1 22 17 17 17 17 17 17 17 20 17 22 20 17 22 17 22 1 1 1 15 14 15 0 0 0 0 14 16 3 1 1 1 22 17 17 17 17 17 17 17 20 17 22 20 17 22 17 22
1 3 3 14 14 15 0 0 0 0 15 0 0 16 3 1 18 17 17 17 17 17 17 17 20 17 22 17 17 17 17 22 1 3 3 14 14 15 0 0 0 0 15 0 0 16 3 1 18 17 17 17 17 17 17 17 20 17 22 17 17 17 17 22
1 15 15 16 0 0 4 5 5 5 6 0 0 0 0 3 1 19 17 18 18 18 17 20 17 22 20 17 19 19 19 17 21 1 15 15 16 0 4 5 5 5 6 0 0 0 0 0 3 1 19 17 18 18 18 17 20 17 22 20 17 19 19 19 17 21
0 15 15 0 0 0 7 13 -1 -1 9 0 0 0 0 1 17 17 18 18 18 17 17 22 22 22 22 19 19 19 17 21 0 15 15 0 0 0 7 13 -1 -1 9 0 0 0 0 1 17 17 18 18 18 17 17 22 22 22 22 19 19 19 17 21
0 15 15 0 0 0 7 -1 -1 -1 9 0 0 0 0 0 20 17 18 18 18 17 17 22 22 22 22 19 19 19 21 21 0 15 15 0 0 0 7 -1 -1 -1 9 0 0 0 0 0 20 17 18 18 18 17 17 22 22 22 22 19 19 19 17 21
3 15 15 0 0 0 7 -1 -1 -1 9 0 0 0 0 0 21 17 17 17 17 17 17 22 22 22 22 17 17 17 21 21 3 15 15 0 0 0 7 -1 -1 -1 9 0 0 0 0 0 21 17 17 17 17 17 17 22 22 22 22 17 17 17 17 21
3 0 0 0 0 0 10 11 11 11 12 0 0 0 2 1 17 17 17 17 17 17 17 22 22 22 22 17 17 17 21 21 3 0 0 0 0 0 10 11 11 11 12 0 0 0 2 1 17 17 17 17 17 17 17 22 22 22 22 17 17 17 17 21
1 2 16 16 16 16 16 0 0 0 0 0 0 0 2 1 17 17 17 17 17 17 17 22 22 22 17 17 17 17 21 21 1 2 16 16 16 16 16 0 0 0 0 0 0 0 2 1 17 17 17 17 17 17 17 22 22 22 17 17 17 17 17 21
1 2 3 16 16 16 16 16 0 0 0 0 3 2 2 1 22 22 22 17 17 17 17 22 22 22 17 17 22 22 21 21 1 2 3 16 16 16 16 16 0 0 0 0 3 2 2 1 22 22 22 17 17 17 17 22 22 22 17 17 22 22 22 21
1 1 2 14 15 15 15 16 0 0 0 0 2 1 1 1 22 22 22 17 17 17 17 17 17 17 17 17 22 22 21 22 1 1 2 14 15 15 15 16 0 0 0 0 2 1 1 1 22 22 22 17 17 17 17 17 17 17 17 17 22 22 22 22
14 14 14 14 14 1 1 0 0 1 1 1 1 1 1 1 22 22 22 17 17 17 17 17 17 17 17 17 22 22 21 22 14 14 14 14 14 1 1 0 0 1 1 1 1 1 1 1 22 22 22 17 17 17 17 17 17 17 17 17 22 22 22 22
16 1 1 1 14 15 1 15 16 1 1 1 1 1 1 1 17 18 20 17 22 17 20 17 22 17 17 17 20 17 22 22 16 1 1 1 14 15 1 15 16 1 1 1 1 1 1 1 17 18 20 17 22 17 20 17 22 17 17 17 20 17 22 22
1 1 1 15 14 15 0 0 0 0 14 16 3 1 1 1 15 17 17 17 17 17 17 17 20 17 22 20 17 22 17 22 1 1 1 15 14 15 0 0 0 0 14 16 3 1 1 1 22 17 17 17 17 17 17 17 20 17 22 20 17 22 17 22
1 3 3 14 14 15 0 0 0 0 15 0 0 16 3 1 15 15 17 17 17 17 17 17 20 17 22 17 17 17 17 22 1 3 3 14 14 15 0 0 0 0 15 0 0 16 3 1 18 17 17 17 17 17 17 17 20 17 22 17 17 17 17 22
1 15 15 16 0 0 4 5 5 5 6 0 0 0 0 3 1 15 15 15 18 18 17 20 17 22 20 17 19 19 19 17 15 1 15 15 16 0 4 5 5 5 6 0 0 0 0 0 3 1 19 17 18 18 18 17 20 17 22 20 17 19 19 19 17 21
0 15 15 0 0 0 7 13 -1 -1 9 0 0 0 0 1 15 15 18 18 18 17 17 22 22 22 22 19 19 19 17 15 0 15 15 0 0 0 7 13 -1 -1 9 0 0 0 0 1 17 17 18 18 18 17 17 22 22 22 22 19 19 19 17 21
0 15 15 0 0 0 7 -1 -1 -1 9 0 0 0 0 0 15 15 18 18 18 17 17 22 22 22 22 19 19 19 17 15 0 15 15 0 0 0 7 -1 -1 -1 9 0 0 0 0 0 20 17 18 18 18 17 17 22 22 22 22 19 19 19 17 21
3 15 15 0 0 0 7 -1 -1 -1 9 0 0 0 0 0 15 17 17 17 17 17 17 22 22 22 22 17 17 17 17 15 3 15 15 0 0 0 7 -1 -1 -1 9 0 0 0 0 0 21 17 17 17 17 17 17 22 22 22 22 17 17 17 17 21
3 0 0 0 0 0 10 11 11 11 12 0 0 0 2 1 15 17 17 17 17 17 17 22 22 22 22 17 17 17 17 15 3 0 0 0 0 0 10 11 11 11 12 0 0 0 2 1 17 17 17 17 17 17 17 22 22 22 22 17 17 17 17 21
1 2 16 16 16 16 16 0 0 0 0 0 0 0 2 1 15 17 17 17 17 17 17 22 22 22 17 17 17 17 17 15 1 2 16 16 16 16 16 0 0 0 0 0 0 0 2 1 17 17 17 17 17 17 17 22 22 22 17 17 17 17 17 21
1 2 3 16 16 16 16 16 0 0 0 0 3 2 2 1 15 22 22 17 17 17 17 22 22 22 17 17 22 22 22 15 1 2 3 16 16 16 16 16 0 0 0 0 3 2 2 1 22 22 22 17 17 17 17 22 22 22 17 17 22 22 22 21
1 1 2 14 15 15 15 16 0 0 0 0 2 1 1 1 15 22 22 17 17 17 17 17 17 17 17 17 22 22 22 15 1 1 2 14 15 15 15 16 0 0 0 0 2 1 1 1 22 22 22 17 17 17 17 17 17 17 17 17 22 22 22 22
14 14 14 14 14 1 1 0 0 1 1 1 1 1 1 1 15 22 22 17 17 17 17 17 17 17 17 17 22 22 22 15 14 14 14 14 14 1 1 0 0 1 1 1 1 1 1 1 22 22 22 17 17 17 17 17 17 17 17 17 22 22 22 22
16 1 1 1 14 15 1 15 16 1 1 1 1 1 1 1 17 18 20 17 22 17 20 17 22 17 17 17 20 17 22 22 16 1 1 1 14 15 1 15 16 1 1 1 1 1 1 1 17 18 20 17 22 17 20 17 22 17 17 17 20 17 22 22
1 1 1 15 14 15 0 0 0 0 14 16 3 1 1 1 22 17 17 17 17 17 17 17 20 17 22 20 17 22 17 22 1 1 1 15 14 15 0 0 0 0 14 16 3 1 1 1 22 17 17 17 17 17 17 17 20 17 22 20 17 22 17 22
1 3 3 14 14 15 0 0 0 0 15 0 0 16 3 1 18 17 17 17 17 17 17 17 20 17 22 17 17 17 17 21 1 3 3 14 14 15 0 0 0 0 15 0 0 16 3 1 18 17 17 17 17 17 17 17 20 17 22 17 17 17 17 22
1 15 15 16 0 0 4 5 5 5 6 0 0 0 0 3 1 19 17 18 18 18 17 20 17 22 20 17 19 19 19 17 21 1 15 15 16 0 4 5 5 5 6 0 0 0 0 0 3 1 19 17 18 18 18 17 20 17 22 20 17 19 19 19 17 21
0 15 15 0 0 0 7 13 -1 -1 9 0 0 0 0 1 17 17 18 18 18 17 17 22 22 22 22 19 19 19 17 21 0 15 15 0 0 0 7 13 -1 -1 9 0 0 0 0 1 17 17 18 18 18 17 17 22 22 22 22 19 19 19 17 21
0 15 15 0 0 0 7 -1 -1 -1 9 0 0 0 0 0 20 17 18 18 18 17 17 22 22 22 22 19 19 19 17 21 0 15 15 0 0 0 7 -1 -1 -1 9 0 0 0 0 0 20 17 18 18 18 17 17 22 22 22 22 19 19 19 17 21
3 15 15 0 0 0 7 -1 -1 -1 9 0 0 0 0 0 21 17 17 17 17 17 17 22 22 22 22 17 17 17 17 21 3 15 15 0 0 0 7 -1 -1 -1 9 0 0 0 0 0 21 17 17 17 17 17 17 22 22 22 22 17 17 17 17 21
3 0 0 0 0 0 10 11 11 11 12 0 0 0 2 1 17 17 17 17 17 17 17 22 22 22 22 17 17 17 17 21 3 0 0 0 0 0 10 11 11 11 12 0 0 0 2 1 17 17 17 17 17 17 17 22 22 22 22 17 17 17 17 21
1 2 16 16 16 16 16 0 0 0 0 0 0 0 2 1 17 17 17 17 17 17 17 22 22 22 17 17 17 17 17 21 1 2 16 16 16 16 16 0 0 0 0 0 0 0 2 1 17 17 17 17 17 17 17 22 22 22 17 17 17 17 17 21
1 2 3 16 16 16 16 16 0 0 0 0 3 2 2 1 18 18 18 17 17 17 17 22 22 22 17 17 22 21 21 21 1 2 3 16 16 16 16 16 0 0 0 0 3 2 2 1 22 22 22 17 17 17 17 22 22 22 17 17 22 22 22 21
1 1 2 14 15 15 15 16 0 0 0 0 2 1 1 1 18 18 18 17 17 17 17 17 17 17 17 17 22 22 21 21 1 1 2 14 15 15 15 16 0 0 0 0 2 1 1 1 22 22 22 17 17 17 17 17 17 17 17 17 22 22 22 22
14 14 14 14 14 1 1 0 0 1 1 1 1 1 1 1 22 22 22 17 17 17 17 17 17 17 17 17 22 22 22 22 14 14 14 14 14 1 1 0 0 1 1 1 1 1 1 1 22 22 22 17 17 17 17 17 17 17 17 17 22 22 22 22
16 1 1 1 14 15 1 15 16 1 1 1 1 1 1 1 17 18 20 17 22 17 20 17 22 17 17 17 20 17 22 22 16 1 1 1 14 15 1 15 16 1 1 1 1 1 1 1 17 18 20 17 22 17 20 17 22 17 17 17 20 17 22 22
1 1 1 15 14 15 0 0 0 0 14 16 3 1 1 1 22 17 17 17 17 17 17 17 20 17 22 20 17 22 17 22 1 1 1 15 14 15 0 0 0 0 14 16 3 1 1 1 22 17 17 17 17 17 17 17 20 17 22 20 17 22 17 22
1 3 3 14 14 15 0 0 0 0 15 0 0 16 3 1 18 17 17 17 17 17 17 17 20 17 22 17 17 17 17 22 1 3 3 14 14 15 0 0 0 0 15 0 0 16 3 1 18 17 17 17 17 17 17 17 20 17 22 17 17 17 17 22
1 15 15 16 0 0 4 5 5 5 6 0 0 0 0 3 1 19 17 18 18 18 17 20 17 22 20 17 19 19 19 17 21 1 15 15 16 0 4 5 5 5 6 0 0 0 0 0 3 1 19 17 18 18 18 17 20 17 22 20 17 19 19 19 17 21
0 15 15 0 0 0 7 13 -1 -1 9 0 0 0 0 1 17 17 18 18 18 17 17 22 22 22 22 19 19 19 17 21 0 15 15 0 0 0 7 13 -1 -1 9 0 0 0 0 1 17 17 18 18 18 17 17 22 22 22 22 19 19 19 17 21
0 15 15 0 0 0 7 -1 -1 -1 9 0 0 0 0 0 20 17 18 18 18 17 17 22 22 22 22 19 19 19 17 21 0 15 15 0 0 0 7 -1 -1 -1 9 0 0 0 0 0 20 17 18 18 18 17 17 22 22 22 22 19 19 19 17 21
3 15 15 0 0 0 7 -1 -1 -1 9 0 0 0 0 0 21 17 17 17 17 17 17 22 22 22 22 17 17 17 17 21 3 15 15 0 0 0 7 -1 -1 -1 9 0 0 0 0 0 21 17 17 17 17 17 17 22 22 22 22 17 17 17 17 21
3 0 0 0 0 0 10 11 11 11 12 0 0 0 2 1 17 17 17 17 17 17 17 22 22 22 22 17 17 17 17 21 3 0 0 0 0 0 10 11 11 11 12 0 0 0 2 1 17 17 17 17 17 17 17 22 22 22 22 17 17 17 17 21
1 2 16 16 16 16 16 0 0 0 0 0 0 0 2 1 17 17 17 17 17 17 17 22 22 22 17 17 17 17 17 21 1 2 16 16 16 16 16 0 0 0 0 0 0 0 2 1 17 17 17 17 17 17 17 22 22 22 17 17 17 17 17 21
1 2 3 16 16 16 16 16 0 0 0 0 3 2 2 1 22 22 22 17 17 17 17 22 22 22 17 17 22 22 22 21 1 2 3 16 16 16 16 16 0 0 0 0 3 2 2 1 22 22 22 17 17 17 17 22 22 22 17 17 22 22 22 21
1 1 2 14 15 15 15 16 0 0 0 0 2 1 1 1 22 22 22 17 17 17 17 17 17 17 17 17 22 22 22 22 1 1 2 14 15 15 15 16 0 0 0 0 2 1 1 1 22 22 22 17 17 17 17 17 17 17 17 17 22 22 22 22
14 14 14 14 14 1 1 0 0 1 1 1 1 1 1 1 22 22 22 17 17 17 17 17 17 17 17 17 22 22 22 22 14 14 14 14 14 1 1 0 0 1 1 1 1 1 1 1 22 22 22 17 17 17 17 17 17 17 17 17 22 22 22 22
16 1 1 1 14 15 1 15 16 1 1 1 1 1 1 1 17 18 20 17 22 17 20 17 22 17 17 17 20 17 22 18 16 1 1 1 14 15 1 15 16 1 1 1 1 1 1 1 17 18 20 17 22 17 20 17 22 17 17 17 20 17 22 22
1 1 1 15 14 15 0 0 0 0 14 16 3 1 1 1 18 18 17 17 17 17 17 17 20 17 22 20 17 22 17 18 1 1 1 15 14 15 0 0 0 0 14 16 3 1 1 1 22 17 17 17 17 17 17 17 20 17 22 20 17 22 17 22
1 3 3 14 14 15 0 0 0 0 15 0 0 16 3 1 18 18 17 17 17 17 17 17 20 17 22 17 17 17 17 18 1 3 3 14 14 15 0 0 0 0 15 0 0 16 3 1 18 17 17 17 17 17 17 17 20 17 22 17 17 17 17 22
1 15 15 16 0 0 0 4 5 5 5 6 0 0 0 3 1 18 18 18 18 18 17 20 17 22 20 17 19 19 19 17 18 1 15 15 16 0 4 5 5 5 6 0 0 0 0 0 3 1 19 17 18 18 18 17 20 17 22 20 17 19 19 19 17 21
0 15 15 0 0 0 7 13 -1 -1 9 0 0 0 0 1 18 17 18 18 18 17 17 22 22 22 22 19 19 19 17 18 0 15 15 0 0 0 7 13 -1 -1 9 0 0 0 0 1 17 17 18 18 18 17 17 22 22 22 22 19 19 19 17 21
0 15 15 0 0 0 7 -1 -1 -1 9 0 0 0 0 0 18 17 18 18 18 17 17 22 22 22 22 19 19 19 17 21 0 15 15 0 0 0 7 -1 -1 -1 9 0 0 0 0 0 20 17 18 18 18 17 17 22 22 22 22 19 19 19 17 21
3 15 15 0 0 0 7 -1 -1 -1 9 0 0 0 0 0 18 17 17 17 17 17 17 22 22 22 22 17 17 17 17 21 3 15 15 0 0 0 7 -1 -1 -1 9 0 0 0 0 0 21 17 17 17 17 17 17 22 22 22 22 17 17 17 17 21
3 0 0 0 0 0 10 11 11 11 12 0 0 0 2 1 18 17 17 17 17 17 17 22 22 22 22 17 17 17 17 21 3 0 0 0 0 0 10 11 11 11 12 0 0 0 2 1 17 17 17 17 17 17 17 22 22 22 22 17 17 17 17 21
1 2 16 16 16 16 16 0 0 0 0 0 0 0 2 1 17 17 17 17 17 17 17 22 22 22 17 17 17 17 17 21 1 2 16 16 16 16 16 0 0 0 0 0 0 0 2 1 17 17 17 17 17 17 17 22 22 22 17 17 17 17 17 21
1 2 3 16 16 16 16 16 0 0 0 0 3 2 2 1 22 22 22 17 17 17 17 22 22 22 17 17 22 22 22 21 1 2 3 16 16 16 16 16 0 0 0 0 3 2 2 1 22 22 22 17 17 17 17 22 22 22 17 17 22 22 22 21
1 1 2 14 15 15 15 16 0 0 0 0 2 1 1 1 22 22 22 17 17 17 17 17 17 17 17 17 22 22 22 22 1 1 2 14 15 15 15 16 0 0 0 0 2 1 1 1 22 22 22 17 17 17 17 17 17 17 17 17 22 22 22 22
14 14 14 14 14 1 1 0 0 1 1 1 1 1 1 1 22 22 22 17 17 17 17 17 17 17 17 17 22 22 22 22 14 14 14 14 14 1 1 0 0 1 1 1 1 1 1 1 22 22 22 17 17 17 17 17 17 17 17 17 22 22 22 22